###########################################
############                    ###########
########## O# #############     ###########
######### O@@O############# @ @@ ##########
######## O@@O################ OOO##########
####### O@@O##################OOO    ######
#####   @@O@                 O@@### Q######
####P     ###################   ###########
######     ##################   ###########
######      ###############################
######       ##############################
###########################################
width:
43
height:
12